# This file explicitly does not have a `.talon-list` extension, because we don't want talon to read it.
# Instead this is included into both and `dictation-list.tolan-list` and `vocabulary.talon-list`.
# as talon doesn't have a "#include" mechanism, the contents of this file is
# added into both of these files by custom code.
#
# The content here replaces the "global vocabulary section" in the target files if already present.
# Otherwise, the content is appended to the existing content of the target files.
# The content is wrapped in comment markers in the target files so that we know what section needs to be replaced.

a b c six: ABC
a b n dash: ABN-
a b r six: ABR
a j n dash: AJN-
a j n six: AJN
a p i six: "API"
a p i gateway: "API Gateway"
a p i: "api"
a w s six: "AWS"
a w s five: "aws"
a w s amplify: "AWS Amplify"
a w s batch: "AWS Batch"
a w s config: "AWS Config"
a w s credentials: "AWSCredentials"
a w s e b s : "AWS EBS"
a w s e c two: "AWS EC2"
a w s e c s : "AWS ECS"
a w s e k s: "AWS EKS"
a w s edge: "AWS Edge"
a w s far gate: "AWS Fargate"
a w s fargate: "AWS Fargate"
a w s glue: "AWS Glue"
a w s i o t : "AWS IoT"
a w s i q : "AWS IQ"
a w s identity centre: "AWS Identity Centre"
a w s lambda: "AWS Lambda"
a w s local zones: "AWS Local Zones"
a w s macie: "AWS Macie"
a w s outposts: "AWS Outposts"
a w s s three: "AWS S3"
a w s shield: "AWS Shield"
a w s v p c : "AWS VPC"
a w s wavelength: "AWS Wavelength"
act on l: Actonel
act on l e c: Actonel EC
air dot: a.
and slash or: and/or
API gateway: API Gateway
add we now: Arduino
add wino: Arduino
a slash d: A/D
ass sure: "Azure"
asset net: Assetnet
b l e six: BLE
b m d six: BMD
beetle one: Beetle
block h: "Bloch"
boolean one: Boolean
broad link: Broadlink
bully in five: boolean
Brian
brief dictionary: dict
cap bat: B
catch ba: Gahba
hug Sameer: Chag sameach
Chag sameach
comma and: ", and"
c s s: css
havre haditha: Chevra Kadisha 
here haditha: Chevra Kadisha 
Hera haditha: Chevra Kadisha 
hero haditha: Chevra Kadisha
c d GitHub back: cd d:\GitHub\
c i c d : "CI/CD"
c l i: cli
c o r s : "CORS"
c r u d: crud
c s g six: CSG
c t scan: CT Scan
cito scape: Cytoscape
clothes five: close
CHOLANGITIS
d a c six: DAC
d b cluster: DB cluster
d b cluster three: DB Cluster
d c p dash: DCP-
d o c: doc
d o m: dom
d slash a: D/A
dialogue: dialog
data point one: DataPoint
data point seven: dataPoint
datapoint one: DataPoint
datapoint seven: dataPoint
day j s: dayjs
doc you saw us: Docusaurus
dock i d three: DocId
dock under i d six: DOC_ID
dock under six: DOC_
double question: " ?? "
double question null: " ?? null"
doctor high field: Dr Highfield
dynamo d b: "DynamoDB"
e n dash: EN-
e dash waste: e-waste
emanuel: Emanuel
Immanuel: Emanuel
entity one: Entity1
entity two: Entity2
e p o a: ePoA
f c f c o a: FCFCOA
f m c six: FMC
fix ologist: Fixologist
form i k: Formik
Gary Bortz
gamma ba: Gahba
gene one: Gen1
Gentoo: Gen2
jill Annie: Gilana
goth ba: Gahba
g o v six: GOV
graph q l : "GraphQL"
had dash phone number: had-phone-number
ho why: Gahba
how why: Gahba
i d: id
i d one: Id
i d e: IDE
i d e six: IDE
i t six: "IT"
i two c: I2C
j ode ya: Joadja
j c a six: JCA
J P six: JP
J P dash: JP-
Jason dot stringy fy: "JSON.stringify("
jupiter lab: JupyterLab
jupiter y: Jupyter
jupiter notebook: Jupyter Notebook
linked in six: LINKEDIN
low dash: lodash
Macquarie park: Macquarie Park
mac cream: Macrium
Macrium reflect: Macrium Reflect
mark c: Marc
mars three six: MARS3
memo eyes: memoize
Menorca monuments: Menucha Monuments
Minorca monuments: Menucha Monuments
minyan: minyan
merit on: Meriton
m u i: mui
my s q l three: "MySql"
my s q l six: "MYSQL"
my s q l: "MySql"
name ass sure: "Azure"
name bigger or waters: Biggera Waters
name bort: Bortz
name Bowral: Bowral
name Camille das Arlo: Camille Dezarnaulds
name crema: Karima
name das Arlo: Dezarnaulds
name day anna: Dhyaana
name dee anna: Dhyaana
name fern: Fern
name glenn: Glenn
name near: Neer
name nova peris: Nova Peris
name car in: Karin
name Ferrer: Ferrer
name jazz man: Jasmann
name Jimenez: Jimenez
name ley or: Lior
name lawn: Lorne
name Leicester: Lester
name Longobardi: Longobardi
name marina: Marina
name miss Abraham: Ms Abraham
name Meyer: Myer
name Mayer Zulaikha: Myer Zulaikha
name nicki c: Nicky
name nicki k: Nikki
name paul: Paul
name pisa: Peisah
Peisah isms: Peisah-isms
name pinball: Pymble
name pro lea: Prolia
name Jackie q: Jacqui
name rob: Rob
name roselle: Rozelle
name save ta: Savta
name ya hell: Yael
name Yael Abraham: Yael Abraham
name Yael Ferrer: Yael Ferrer
name Yael Jimenez: Yael Jimenez
navy bar one: NavBar
navy one: Nav
neo four j: "Neo4j"
necks em: Nexium
new n: new
nice fy: niceify
nice fide: niceified
nine bot: Ninebot
nine bot s two: Ninebot S2
n d i s: NDIS
n m v six: NMV
n p m run: "npm run "
n p m run build: "npm run build"
n p m run dev: "npm run dev"
n p m run serve: "npm run serve"
a lanza pin: Olanzapine
one drive: OneDrive
o p five: "op"
Oh hell hayim: Ohel Chaim
p d f dot j s: PDF.js
p d f one: Pdf
p d f five: pdf
p d f six: PDF
Phillips Hugh: Philips Hue
pipe null: " | null"
placed-ad-for: 
post gres: "Postgres"
post gres s q l: "PostgresSQL"
p r o p s: props
p r p six: PRP
p w m six: PWM
q under: "q_"
react one: React
red brace: }
Ronny
Ronny Zulaikha
Brookwood: Rookwood
rose: rows
rose w: rows
rye al tress: Ryaltris
s m h: SMH
s q l six: "SQL"
s three: "S3"
s three bucket one: "S3Bucket"
saint vincents: "St Vincent's"
saint george: "St George"
Sat vincents: "St Vincent's"
sit vincents: "St Vincent's"
save ta: Savta
se: see
seg bot: Segbot
segue: Segway
shoe e: shoe
shoe spec: shoe spec
sauce o: source
sauce under six: SOURCE_
sparkle q: SPARQL
spec c: spec
speck c: spec
specie: spec
Speccy: spec
Stephen v: Steven
s v g: svg
s v g six: SVG
System net: Systemnet
t n dash: TN-
talent: Talon
u r l: url
u u i d: uuid
up sort: upsert
used dash name: used-name
v i s: vis
v i t e: vite
vera bored: veroboard
vitamin k two: vitamin K2
whats at: WhatsApp
wool lara: Woollahra
Woollahra
work space: workspace
wood l: would
right w: write
Zulaikha

